지역,선거인수,투표수,대통합민주신당 정동영,한나라당 이명박,민주노동당 권영길,민주당 이인제,창조한국당 문국현,참주인연합 정근모,겅제공화당 허경영,새시대참사람연합 전관,한국사회당 금민,무소속 이회창,계,무효,기권
서울 종로구,133946,85480,21515,45172,1889,398,5722,56,331,13,77,9984,85157,323,48466
서울 중구,106837,66496,17299,35335,1387,328,4324,33,240,9,52,7278,66285,211,40341
서울 용산구,190910,117051,25967,66096,2358,532,7544,78,486,12,77,13554,116704,347,73859
서울 성동구,266124,165391,41902,88602,3811,894,11330,100,727,38,118,17389,164911,480,100733
서울 광진구,297332,183412,46597,94864,4159,845,14052,106,943,33,114,21275,182988,424,113920
서울 동대문구,304410,190407,49064,100709,4443,910,12660,79,826,41,138,20931,189801,606,114003
서울 중랑구,337898,204119,54085,105608,4913,961,13083,89,1066,31,150,23503,203489,630,133779
서울 성북구,373761,235180,60790,123186,5597,1062,17007,147,958,30,193,25572,234542,638,138581
서울 강북구,277954,168236,47290,85791,4278,1039,10913,91,770,36,121,17373,167702,534,109718
서울 도봉구,293138,188015,46515,99596,4563,842,13355,88,795,42,101,21578,187475,540,105123
서울 노원구,466884,306503,76021,157439,8445,1351,22951,207,1274,77,213,37607,305585,918,160381
서울 은평구,362685,218004,59909,108240,5069,1127,15139,127,1020,51,183,26376,217241,763,144681
서울 서대문구,278848,174263,46522,87645,4364,828,12833,118,752,24,135,20548,173769,494,104585
서울 마포구,315333,194947,49343,97347,5627,863,16037,120,889,35,218,23936,194415,532,120386
서울 양천구,378841,241697,59636,127919,5232,966,16751,156,1011,46,137,29211,241065,632,137144
서울 강서구,436622,272240,68471,138876,6363,1335,20464,189,1440,51,169,33701,271059,1181,164382
서울 구로구,333323,211497,55683,102968,5587,1169,16083,110,1021,31,143,28102,210897,600,121826
서울 금천구,196513,118869,34966,55968,3289,767,7597,64,545,28,90,15140,118454,415,77644
서울 영등포구,325884,206002,51008,106558,4716,962,14819,124,873,44,138,26129,205371,631,119882
서울 동작구,326851,209902,53613,106067,4988,1010,16943,144,980,49,145,25411,209350,552,116949
서울 관악구,439707,268101,77804,121270,8362,1695,23536,167,1321,56,247,32942,267400,701,171606
서울 서초구,320018,212282,34112,136443,2969,582,13223,133,700,15,124,23535,211836,446,107736
서울 강남구,442286,283231,41493,187778,3806,722,16465,177,989,23,142,31023,282618,613,159055
서울 송파구,483567,313620,66697,180704,5499,1100,20642,162,1344,53,162,36436,312799,821,169947
서울 강동구,362024,231077,51510,128981,4630,926,15308,148,1104,43,114,27692,230456,621,130947
부산 중구,42111,25584,3226,15672,516,65,1208,9,89,6,15,4658,25464,120,16527
부산 서구,109489,65288,8314,39620,1566,169,3025,31,251,19,48,11967,65010,278,44201
부산 동구,87511,54017,6780,31708,1384,150,2402,21,242,11,33,11067,53798,219,33494
부산 영도구,127967,75664,13008,41811,2481,221,3613,40,284,23,38,13807,75326,338,52303
부산 부산진구,324855,200613,26287,115334,5511,558,10608,81,834,40,133,40587,199973,640,124242
부산 동래구,225283,144883,16957,86308,3669,313,7919,53,630,23,123,28480,144475,408,80400
부산 남구,237462,148749,19494,86574,4181,367,7962,50,576,34,89,28994,148321,428,88713
부산 북구,247521,154739,22441,84137,4895,433,8836,81,709,36,116,32511,154195,544,92782
부산 해운대구,322575,202750,26921,118502,5531,441,11234,106,747,44,125,38551,202202,548,119825
부산 기장군,62272,38759,4951,22799,1311,99,1684,25,165,12,16,7513,38575,184,23513
부산 사하구,283276,171149,24215,98782,4806,446,9619,63,699,43,122,31723,170518,631,112127
부산 금정구,206527,131508,15925,77336,3704,329,7393,63,585,35,91,25631,131092,416,75019
부산 강서구,43825,25623,3700,14549,722,99,994,20,95,5,14,5237,25435,188,18202
부산 연제구,169739,108433,13445,63080,2905,244,6072,37,504,21,84,21688,108080,353,61306
부산 수영구,144300,91170,10807,54832,2069,206,4961,32,395,18,54,17574,90948,222,53130
부산 사상구,208350,126302,20237,67671,3650,459,6755,58,546,36,97,26331,125840,462,82048
대구 중구,66234,43459,2502,30882,706,57,1525,22,104,4,31,7469,43302,157,22775
대구 동구,265762,176279,11357,120170,3560,299,7046,70,486,38,102,32448,175576,703,89483
대구 서구,190185,120295,6600,83998,2087,188,3907,31,302,26,86,22579,119804,491,69890
대구 남구,146210,92611,5457,63764,1661,138,3455,24,281,14,71,17395,92260,351,53599
대구 북구,341870,229360,14386,156772,4868,330,9990,46,629,31,113,41470,228635,725,112510
대구 수성구,330137,230474,12665,164557,3851,241,9423,62,562,35,116,38408,229920,554,99663
대구 달서구,437650,296170,17634,203226,6227,413,12318,83,796,48,162,54434,295341,829,141480
대구 달성군,118818,79321,5331,53350,2817,181,2850,29,215,25,46,13996,78840,481,39497
인천 중구,71324,41139,8755,21199,1381,256,2726,33,194,10,29,6347,40930,209,30185
인천 동구,59570,37098,8265,17655,1597,269,2497,28,179,16,36,6343,36885,213,22472
인천 남구,326395,190852,41666,95605,6032,1174,13493,96,919,39,176,30906,190106,746,135543
인천 연수구,195285,125814,25170,66280,4230,578,9380,88,512,23,93,19081,125435,379,69471
인천 남동구,317999,192315,45763,93371,6486,1225,13906,128,921,54,179,29562,191595,720,125684
인천 부평구,430072,258527,65803,122367,9702,1578,18371,181,1198,64,208,38072,257544,983,171545
인천 계양구,248876,147573,39757,67374,5112,897,10932,98,739,41,146,21942,147038,535,101303
인천 서구,286985,170454,43355,81884,6216,1157,11638,96,807,41,159,24462,169815,639,116531
인천 강화군,55196,36766,6166,22075,1070,388,1488,40,219,26,31,4975,36478,288,18430
인천 옹진군,14172,9682,1865,5473,243,90,383,9,81,9,11,1367,9531,151,4490
광주 동구,90124,55737,43391,5450,834,839,2596,30,142,15,19,2206,55522,215,34387
광주 서구,222662,144859,114717,13004,2882,1374,7057,76,329,14,59,4993,144505,354,77803
광주 남구,158988,101716,80271,9616,1555,1318,4779,51,235,14,39,3609,101487,229,57272
광주 북구,344625,220888,176435,18291,4149,2236,10931,146,512,25,106,7502,220333,555,123737
광주 광산구,214934,140138,112774,10514,4177,1351,6161,95,329,28,66,4210,139705,433,74796
대전 동구,191518,113405,29102,37863,2853,1464,6921,88,426,44,130,33970,112861,544,78113
대전 중구,204994,126057,28964,46023,2774,1445,7841,81,457,34,110,37915,125644,413,78937
대전 서구,368547,230752,51476,86050,5088,2309,16487,132,744,57,235,67522,230100,652,137795
대전 유성구,176526,114086,26382,43017,3264,874,10644,91,372,26,103,28974,113747,339,62440
대전 대덕구,157392,95964,23776,33055,3228,1131,6250,75,357,43,105,27576,95596,368,61428
울산 중구,177386,112934,13670,63101,8371,414,5849,57,426,19,95,20427,112429,505,64452
울산 남구,252020,163310,19581,92717,9549,459,9279,67,630,35,117,30244,162678,632,88710
울산 동구,136997,87909,16129,43337,9098,399,5344,58,408,27,91,12621,87512,397,49088
울산 북구,106264,71100,10201,33363,11797,239,3818,31,270,15,79,10926,70739,361,35164
울산 울주군,133756,85963,11155,47373,4792,373,4315,58,365,25,85,16687,85228,735,47793
경기 수원시장안구,210171,133783,30641,64832,4402,751,10787,94,597,31,96,21176,133407,376,76388
경기 수원시권선구,227968,135070,31545,65272,4140,834,10157,95,647,47,105,21784,134626,444,92898
경기 수원시팔달구,169529,97064,21255,48972,2592,645,7260,72,456,29,78,15331,96690,374,72465
경기 수원시영통구,175615,111290,23571,56136,2895,459,10290,68,542,25,74,16999,111059,231,64325
경기 성남시수정구,202875,113585,34521,51580,3392,942,7911,87,582,35,77,14015,113142,443,89290
경기 성남시중원구,205596,114597,34835,52703,3333,969,7374,74,614,27,92,14194,114215,382,90999
경기 성남시분당구,321923,218340,36746,134060,4080,626,15577,139,736,34,109,25735,217842,498,103583
경기 의정부시,314746,191670,46445,100542,5483,1016,12525,113,1001,40,71,23806,191042,628,123076
경기 안양시만안구,205444,127123,32071,60840,3503,823,9768,70,590,31,79,18799,126574,549,78321
경기 안양시동안구,261803,176837,40389,90423,4300,742,15119,97,760,26,107,24255,176218,619,84966
경기 부천시원미구,333326,202315,53939,95829,5636,1119,15556,114,1010,39,135,28392,201769,546,131011
경기 부천시소사구,174754,106639,28322,50341,3110,631,8117,81,584,22,67,15003,106278,361,68115
경기 부천시오정구,140783,79906,24222,36051,2150,609,5149,46,418,23,63,10856,79587,319,60877
경기 광명시,236416,149929,41736,69944,4888,911,11077,98,744,29,82,19985,149494,435,86487
경기 평택시,296098,176789,37120,88319,10314,1451,10959,107,843,53,122,26749,176037,752,119309
경기 양주시,133824,79527,18409,43554,2088,555,4465,71,456,27,45,9468,79138,389,54297
경기 동두천시,67629,38221,8741,21126,968,329,1878,32,183,11,25,4739,38032,189,29408
경기 안산시상록구,266293,153609,43183,70545,4878,1014,11353,112,738,37,120,21086,153066,543,112684
경기 안산시단원구,238970,134675,38367,61105,4516,977,9275,89,640,40,76,19069,134154,521,104295
경기 고양시덕양구,283032,176306,43375,91510,4759,845,12527,131,681,49,128,21771,175776,530,106726
경기 고양시일산동구,184138,115854,25295,63571,2838,383,9055,69,393,26,73,13833,115536,318,68284
경기 고양시일산서구,204400,132601,29467,72844,3260,470,10042,56,407,20,82,15617,132265,336,71799
경기 과천시,45430,32075,6308,18228,868,82,2603,27,117,8,16,3736,31993,82,13355
경기 의왕시,101448,66677,15670,33605,1824,340,5431,48,282,10,38,9216,66464,213,34771
경기 구리시,144987,91250,20746,49370,2338,472,6259,41,499,14,45,11210,90994,256,53737
경기 남양주시,361363,219433,50520,119873,5370,1289,14217,150,1180,56,121,25954,218730,703,141930
경기 오산시,103848,60027,14370,28666,2150,463,4462,35,296,12,50,9304,59808,219,43821
경기 화성시,265536,159514,34968,81713,6170,1116,10972,84,781,39,112,22891,158846,668,106022
경기 시흥시,277333,157636,45012,72523,4810,1108,10577,105,848,26,98,22013,157120,516,119697
경기 군포시,203559,133078,32262,63844,4204,651,11661,72,601,26,75,19311,132707,371,70481
경기 하남시,106527,65545,15325,35272,1337,354,4135,35,321,16,36,8493,65324,221,40982
경기 파주시,228024,138055,30084,76460,3812,902,8497,94,615,67,86,16782,137399,656,89969
경기 여주군,82266,49800,9214,27822,1601,511,2739,32,244,27,53,7193,49436,364,32466
경기 이천시,144497,83665,15257,47323,2451,719,5428,63,414,34,65,11390,83144,521,60832
경기 용인시처인구,151077,87778,20100,46632,2271,729,5375,88,449,36,72,11629,87381,397,63299
경기 용인시수지구,211290,140500,24687,85920,2589,349,10002,86,442,16,53,16058,140202,298,70790
경기 용인시기흥구,217439,140377,29436,77906,3203,503,11149,118,572,16,57,17072,140032,345,77062
경기 안성시,124360,73933,16282,36971,3097,685,4502,80,429,34,76,11333,73489,444,50427
경기 김포시,153236,96255,20342,54078,2439,623,5762,60,418,20,38,12079,95859,396,56981
경기 광주시,171826,104240,23821,58125,2207,737,6120,65,477,36,65,12197,103850,390,67586
경기 포천시,120695,71154,14971,40396,2098,704,3720,56,407,46,57,8234,70689,465,49541
경기 연천군,36588,23834,5441,13072,678,267,1111,25,125,19,20,2865,23623,211,12754
경기 양평군,70828,45899,7463,28550,1080,473,2171,61,225,21,39,5451,45534,365,24929
경기 가평군,44634,29186,5462,16995,708,335,1378,38,190,32,29,3669,28836,350,15448
강원 춘천시,196492,125883,22632,66113,4352,792,9591,95,757,51,106,20698,125187,696,70609
강원 원주시,222473,134205,25195,68001,6322,990,8623,133,905,47,188,23042,133446,759,88268
강원 강릉시,170634,105225,15492,57934,3294,534,6288,71,1066,47,107,19740,104573,652,65409
강원 동해시,74275,45514,7256,23942,1513,262,2594,30,236,11,42,9302,45188,326,28761
강원 삼척시,56902,36635,6030,18696,1296,268,1621,30,171,22,51,8121,36306,329,20267
강원 태백시,40897,24364,4050,12227,964,188,1344,8,96,6,27,5280,24190,174,16533
강원 정선군,34720,21600,4772,9705,978,286,874,25,106,29,44,4535,21354,246,13120
강원 속초시,64461,36959,6597,20765,1183,201,2169,18,261,26,21,5553,36794,165,27502
강원 고성군,24828,16112,3053,9058,508,153,702,13,100,10,13,2373,15983,129,8716
강원 양양군,23327,15507,2985,8133,540,153,694,13,118,7,16,2691,15350,157,7820
강원 인제군,25011,16576,4193,7640,591,207,985,18,118,41,16,2571,16380,196,8435
강원 홍천군,55527,35562,8539,17210,1536,514,1706,36,303,30,53,5303,35230,332,19965
강원 횡성군,35075,23250,5168,11162,1220,298,1084,24,190,22,44,3766,22978,272,11825
강원 영월군,32950,21913,4922,10435,778,301,935,27,125,21,33,4059,21636,277,11037
강원 평창군,35702,22624,5198,10828,799,239,1072,25,190,21,38,3974,22384,240,13078
강원 화천군,18066,11854,2748,5827,528,202,569,16,88,15,16,1698,11707,147,6212
강원 양구군,16648,11163,2794,5113,511,193,579,12,96,13,15,1714,11040,123,5485
강원 철원군,36667,23949,5044,13215,1216,304,1122,21,137,17,19,2682,23777,172,12718
청주시상당구,184975,111986,24361,46133,3349,948,7176,81,562,31,82,28669,111392,594,72989
청주시흥덕구,277547,165610,36408,66251,5506,1343,11728,93,764,45,164,42510,164812,798,111937
충북 충주시,157206,94852,20282,45089,2972,1097,5201,63,597,41,60,18583,93985,867,62354
충북 제천시,105649,66705,13123,30743,2620,643,3290,42,377,38,77,15081,66034,671,38944
충북 단양군,26564,17457,3873,7552,633,225,785,23,114,11,21,3957,17194,263,9107
충북 청원군,109982,67302,18173,25120,2309,874,3893,65,275,39,92,15678,66518,784,42680
충북 영동군,41056,27267,7113,11464,1170,363,1033,34,96,12,45,5502,26832,435,13789
충북 보은군,29383,19907,6978,6880,726,368,781,15,88,15,23,3729,19603,304,9476
충북 옥천군,44227,29097,9178,9731,1160,507,1252,36,116,22,63,6540,28605,492,15130
충북 음성군,68117,39820,10210,16303,1823,602,1948,51,194,31,38,8161,39361,459,28297
충북 진천군,46260,27916,7549,10792,1446,432,1315,23,142,14,30,5862,27605,311,18344
충북 괴산군,31545,20753,4786,8404,1163,377,742,27,38,10,44,4787,20378,375,10792
충북 증평군,23591,13921,3603,5037,408,186,740,8,72,12,20,3691,13777,144,9670
충남 천안시,384145,223871,47217,90229,8381,2093,14876,196,972,65,218,58549,222796,1075,160274
충남 공주시,100441,60827,13301,16936,1639,1378,2732,54,262,37,78,23789,60206,621,39614
충남 보령시,85009,52590,10172,16630,1686,1217,1972,85,190,40,79,19876,51947,643,32419
충남 아산시,167540,94122,18665,35318,5331,1023,5165,67,477,28,122,27337,93533,589,73418
충남 서산시,115264,69287,14056,26335,2648,1263,3285,57,350,41,69,20533,68637,650,45977
충남 태안군,51230,31923,7355,11033,927,723,1331,41,137,28,53,9836,31464,459,19307
충남 금산군,46603,28558,8063,9005,809,1202,956,41,115,27,42,7954,28214,344,18045
충남 연기군,63317,42235,10525,11585,1042,705,1943,74,192,31,50,15084,41231,1004,21082
충남 논산시,102616,61078,17311,17467,1776,6964,2317,79,236,68,67,14230,60515,563,41538
충남 계룡시,25719,17187,3808,7639,308,284,1105,9,60,14,14,3873,17114,73,8532
충남 부여군,63526,39879,8562,11784,1469,2183,1417,52,141,64,75,13634,39381,498,23647
충남 서천군,50538,31927,8302,9823,1165,939,946,42,95,29,54,10144,31539,388,18611
충남 홍성군,70470,44195,6891,13117,1174,651,1497,39,157,27,56,20133,43742,453,26275
충남 청양군,27914,18733,3172,4926,538,593,514,23,70,14,37,8606,18493,240,9181
충남 예산군,72086,48521,4350,9487,753,283,825,22,119,25,51,32227,48142,379,23565
충남 당진군,106333,59106,11249,22379,2486,1091,2502,53,241,30,66,18454,58551,555,47227
전북 전주시완산구,255669,173723,140317,16560,2368,1033,6064,95,367,19,62,6392,173277,446,81946
전북 전주시덕진구,203973,138028,111433,12304,2839,718,4877,58,330,16,49,5061,137685,343,65945
전북 군산시,198926,125277,96750,14338,3354,753,4050,95,191,17,49,5203,124800,477,73649
전북 익산시,236123,151701,120624,15429,3235,1360,4571,96,291,34,78,5407,151125,576,84422
전북 정읍시,97592,65233,54890,4835,1231,359,1291,25,100,16,36,1973,64756,477,32359
전북 남원시,69951,49456,42232,3299,613,331,856,18,56,14,38,1629,49086,370,20495
전북 김제시,79810,54726,46019,4250,772,419,1090,29,75,16,36,1675,54381,345,25084
전북 완주군,65917,44710,36557,3500,1292,356,1016,31,91,16,40,1550,44449,261,21207
전북 진안군,22970,16059,13276,1240,234,136,319,14,38,13,15,616,15901,158,6911
전북 무주군,21099,14660,11305,1641,277,118,315,12,37,7,10,789,14511,149,6439
전북 장수군,19853,14224,11614,1151,309,104,227,2,29,12,15,602,14065,159,5629
전북 임실군,26931,19427,16454,1276,200,184,250,13,21,17,20,775,19210,217,7504
전북 순창군,25208,19324,17343,771,248,76,149,12,20,9,15,477,19120,204,5884
전북 고창군,50039,34236,28901,2308,533,249,559,26,51,19,36,1237,33919,317,15803
전북 부안군,50995,36791,29521,3247,634,354,939,64,80,45,39,1244,36167,624,14204
전남 목포시,179160,104320,83225,9604,2164,1518,3800,64,200,19,64,3255,103913,407,74840
전남 여수시,223347,139798,109765,13489,3047,2197,5159,82,402,37,70,4838,139086,712,83549
전남 순천시,196303,125839,97384,12177,3102,1995,5283,72,263,37,65,4851,125229,610,70464
전남 나주시,77930,51998,41506,3920,1204,1713,1426,35,108,37,37,1500,51486,512,25932
전남 광양시,98340,62793,43204,9013,2031,1130,3085,51,201,14,24,3736,62489,304,35547
전남 담양군,41587,28834,23872,1974,436,519,665,28,55,13,24,992,28578,256,12753
전남 장성군,38966,29003,22841,2500,411,589,898,184,77,19,17,1029,28565,438,9963
전남 곡성군,27604,19181,15521,1247,618,480,348,17,40,17,12,654,18954,227,8423
전남 구례군,23231,16090,12480,1448,539,370,375,17,44,6,15,656,15950,140,7141
전남 고흥군,66681,44303,34207,4003,658,2401,870,22,54,28,35,1491,43769,534,22378
전남 보성군,42498,28000,20610,3213,744,1033,867,32,68,17,42,1056,27682,318,14498
전남 화순군,55659,35684,28138,2632,1099,923,1214,18,75,22,38,1261,35420,264,19975
전남 장흥군,35526,26481,19730,2216,960,884,939,60,149,39,29,986,25992,489,9045
전남 강진군,33693,22087,16564,2265,689,673,601,19,44,14,22,976,21867,220,11606
전남 완도군,46449,30496,24615,2132,511,1171,613,26,45,18,21,977,30129,367,15953
전남 해남군,67227,45542,35193,3535,1176,1782,1259,67,99,43,42,1487,44683,859,21685
전남 진도군,29034,18856,15164,1598,344,413,412,14,33,9,16,614,18617,239,10178
전남 영암군,47590,31323,24145,3031,1136,687,886,20,61,15,17,967,30965,358,16267
전남 무안군,51219,32718,26267,2703,727,859,757,35,51,16,29,927,32371,347,18501
전남 영광군,47268,32207,25768,2466,861,471,796,32,49,55,83,1204,31785,422,15061
전남 함평군,31915,22101,17937,1643,305,640,526,17,37,27,20,648,21800,301,9814
전남 신안군,39604,23807,19173,2025,416,626,510,26,24,15,21,685,23521,286,15797
경북 포항시북구,191990,140685,6757,118169,2678,148,3852,37,204,18,54,8143,140060,625,51305
경북 포항시남구,193356,136640,8910,108775,3355,248,4433,45,291,22,72,9754,135905,735,56716
경북 울릉군,8561,5834,554,4342,99,14,162,4,25,0,5,588,5793,41,2727
경북 경주시,211623,145887,8968,107948,6366,342,4498,59,396,38,100,16157,144872,1015,65736
경북 김천시,109767,74936,4707,50908,1533,234,2882,38,229,29,76,13631,74267,669,34831
경북 안동시,133566,90343,6599,59978,2829,222,3256,90,328,46,119,15854,89321,1022,43223
경북 구미시,280481,172422,12743,114803,4386,381,8233,58,752,31,96,30175,171658,764,108059
경북 영주시,91618,63686,4704,43029,1813,229,2212,45,205,31,105,10694,63067,619,27932
경북 영천시,86531,60974,4348,44263,1499,244,1768,97,216,78,159,7326,59998,976,25557
경북 상주시,87304,62722,4321,44152,1712,251,1483,49,287,40,88,9508,61891,831,24582
경북 문경시,61373,43068,2834,30867,856,158,1010,20,149,23,53,6612,42582,486,18305
경북 예천군,41837,29903,2282,20464,880,101,700,26,91,14,51,4774,29383,520,11934
경북 경산시,181228,117751,7775,79438,3164,231,4669,52,355,32,76,21393,117185,566,63477
경북 청도군,39106,29630,1885,20077,726,130,930,60,197,138,47,4903,29093,537,9476
경북 고령군,28742,19990,1462,13420,635,67,500,14,65,13,29,3518,19723,267,8752
경북 성주군,38277,26370,1691,18615,666,93,649,13,55,22,39,4207,26050,320,11907
경북 칠곡군,85733,53075,4147,35502,1286,142,2255,15,192,17,40,9120,52716,359,32658
경북 군위군,22558,16452,1047,12147,394,58,293,7,34,6,25,2223,16234,218,6106
경북 의성군,53346,38182,2517,27525,1493,147,814,17,87,38,57,5006,37701,481,15164
경북 청송군,23708,17932,1571,12422,609,89,581,17,127,13,22,2115,17566,366,5776
경북 영양군,16408,11710,1120,8199,440,48,296,8,25,6,22,1366,11530,180,4698
경북 영덕군,36879,27649,1377,23129,482,52,372,8,47,9,20,1763,27259,390,9230
경북 봉화군,29972,21290,1812,13981,819,103,568,19,124,17,67,3402,20912,378,8682
경북 울진군,43430,30078,2691,21804,607,91,929,21,215,18,36,3294,29706,372,13352
경남 창원시,362408,231700,29081,119272,18327,537,13263,91,888,50,121,48987,230617,1083,130708
경남 마산시,324462,209020,20557,122030,8730,480,9677,62,720,45,114,45251,207666,1354,115442
경남 진주시,250883,167564,15332,97767,7752,398,7629,82,650,55,96,36341,166102,1462,83319
경남 진해시,121833,79408,9834,43764,3417,234,4351,44,272,29,45,16901,78891,517,42425
경남 통영시,104365,64408,6610,38853,2293,229,2523,42,218,33,52,12761,63614,794,39957
경남 고성군,45808,29676,3268,16716,1254,120,946,27,109,16,50,6621,29127,549,16132
경남 사천시,88020,57258,5945,31520,2774,185,2166,32,188,19,67,13639,56535,723,30762
경남 김해시,328602,196486,33010,94923,8619,595,12154,109,880,57,138,44945,195430,1056,132116
경남 밀양시,90039,59131,7002,32527,2255,222,2324,52,192,31,52,13612,58269,862,30908
경남 거제시,150738,88567,13614,45598,8622,360,4225,37,375,27,58,14908,87824,743,62171
경남 의령군,25869,18150,1849,9440,1103,88,486,50,80,20,30,4472,17618,532,7719
경남 함안군,51439,36737,3930,19584,2317,142,1534,165,212,33,38,8177,36132,605,14702
경남 창녕군,51627,35815,3698,19389,1831,197,1347,207,157,33,63,8217,35139,676,15812
경남 양산시,168925,101284,14220,55734,4367,320,5490,64,413,27,68,19877,100580,704,67641
경남 하동군,45826,30695,5097,15618,1677,166,1086,30,105,34,42,6120,29975,720,15131
경남 남해군,45169,30603,4709,15991,1404,176,902,30,127,20,45,6505,29909,694,14566
경남 함양군,33470,25093,3200,13967,1087,150,966,123,147,33,40,4794,24507,586,8377
경남 산청군,30086,21140,2055,12239,1482,87,552,11,93,13,35,4037,20604,536,8946
경남 거창군,50823,34594,3637,19863,1708,127,1345,26,128,20,45,6982,33881,713,16229
경남 합천군,45959,31741,2815,18867,1626,122,927,26,109,17,62,6339,30910,831,14218
제주 제주시,296325,181304,56798,70297,7059,1124,15142,114,929,90,227,27824,179604,1700,115021
제주 서귀포시,117697,70807,24772,26198,3895,550,4279,38,344,54,117,9671,69918,889,46890
